%%%%%%%%%%
%    % . %
% %%%%%% %
% %    % %
% % %% % %
% % %% % %
% % P% % %
% %%%% % %
%      % %
% %%%%%% %
%        %
%%%%%%%%%%